*********************
*S            *     *
*** ********* * *** *
*     *       *   * *
* *** * ***** *** * *
*   * * *   *     * *
*** * * * * ******* *
*   * * * *         *
* *** * * ********* *
* *   *   *       * *
* ***** *** ***** ***
*       *     *     *
* ********* *** *****
*        E*         *
*********************